ID,NAMES,population,agriculteurs,artisans,cadres,intermediaires,employe,ouvrier,total
75101,Paris 1er Arrondissement,17443,19,763,5230,2134,1778,438,10362
75102,Paris 2e  Arrondissement,22927,7,832,7138,3052,2248,1169,14446
75103,Paris 3e  Arrondissement,36120,24,1326,11154,5003,3418,1160,22085
75104,Paris 4e  Arrondissement,27887,21,1036,7770,3578,2696,638,15739
75105,Paris 5e  Arrondissement,60800,28,1388,16527,6857,4671,1282,30753
75106,Paris 6e  Arrondissement,43880,61,1551,10687,4065,3414,897,20675
75107,Paris 7e  Arrondissement,57786,39,2196,14397,5230,4785,1412,28059
75108,Paris 8e  Arrondissement,40589,51,1656,10395,3811,3769,1106,20788
75109,Paris 9e  Arrondissement,60120,60,2116,17955,7752,5757,1925,35565
75110,Paris 10e  Arrondissement,94027,22,2585,23634,13075,11107,5597,56020
75111,Paris 11e  Arrondissement,154647,65,3918,40738,23681,17041,6699,92142
75112,Paris 12e  Arrondissement,144402,31,2897,36343,20388,15809,5565,81033
75113,Paris 13e  Arrondissement,183260,30,3335,37109,23741,23372,8060,95647
75114,Paris 14e  Arrondissement,140317,44,2669,33942,17247,14864,4623,73389
75115,Paris 15e  Arrondissement,238395,107,5120,63059,29743,23334,7166,128529
75116,Paris 16e  Arrondissement,169942,198,6485,37053,15406,14405,3527,77074
75117,Paris 17e  Arrondissement,170174,100,5005,43538,20446,17728,6611,93428
75118,Paris 18e  Arrondissement,203127,60,4886,41525,27914,26481,13791,114657
75119,Paris 19e  Arrondissement,186090,35,4346,28736,24726,26619,11389,95851
75120,Paris 20e  Arrondissement,198042,17,3926,34351,28087,27702,12790,106873
77001,Acheres-la-Foret,1232,12,48,147,135,143,91,576
77002,Amillis,781,4,15,31,108,143,74,375
77003,Amponville,388,4,28,44,52,64,32,224
77004,Andrezel,299,12,20,40,28,28,24,152
77005,Annet-sur-Marne,3229,0,128,424,564,404,252,1772
77006,Arbonne-la-Foret,1025,4,36,96,128,128,32,424
77007,Argentieres,395,0,4,37,83,50,45,219
77008,Armentieres-en-Brie,1399,0,12,57,166,146,101,482
77009,Arville,127,4,8,4,16,20,16,68
77010,Aubepierre-Ozouer-le-Repos,895,8,45,49,130,102,134,468
77011,Aufferville,547,16,20,44,91,71,60,302
77012,Augers-en-Brie,304,4,16,16,44,24,56,160
77013,Aulnoy,386,0,4,40,44,52,64,204
77014,Avon,14084,0,193,1483,1917,2079,1074,6746
77015,Baby,94,4,0,4,12,8,8,36
77016,Bagneaux-sur-Loing,1695,0,24,44,88,314,334,804
77018,Bailly-Romainvilliers,6884,0,156,824,1180,1324,412,3896
77019,Balloy,325,8,12,20,37,37,49,163
77020,Bannost-Villegagnon,649,12,19,39,123,85,93,371
77021,Barbey,195,0,8,0,25,29,37,99
77022,Barbizon,1357,12,73,125,161,113,81,565
77023,Barcy,249,0,11,7,51,25,29,123
77024,Bassevelle,349,4,16,45,37,45,37,184
77025,Bazoches-les-Bray,826,8,33,33,85,126,114,399
77026,Beauchery-Saint-Martin,411,12,8,20,52,68,40,200
77027,Beaumont-du-Gatinais,1159,16,44,40,88,164,116,468
77028,Beautheil,724,12,16,71,94,126,59,378
77029,Beauvoir,194,0,4,21,29,29,33,116
77030,Bellot,799,8,8,61,110,115,115,417
77031,Bernay-Vilbert,843,20,32,85,113,109,85,444
77032,Beton-Bazoches,812,19,30,33,59,104,138,383
77033,Bezalles,236,11,0,15,26,37,34,123
77034,Blandy,735,4,37,95,137,70,37,380
77035,Blennes,566,0,29,68,103,68,28,296
77036,Boisdon,97,9,4,0,0,22,13,48
77037,Bois-le-Roi,5649,0,167,1044,829,442,190,2672
77038,Boissettes,463,0,20,72,60,32,20,204
77039,Boissise-la-Bertrand,1068,0,23,148,152,95,53,471
77040,Boissise-le-Roi,3616,0,119,358,481,399,261,1618
77041,Boissy-aux-Cailles,311,20,8,48,44,44,4,168
77042,Boissy-le-Chatel,3110,0,72,152,453,480,356,1513
77043,Boitron,396,4,16,28,44,69,48,209
77044,Bombon,860,0,8,64,144,120,72,408
77045,Bougligny,720,4,43,43,83,95,95,363
77046,Boulancourt,370,4,24,16,63,47,39,193
77047,Bouleurs,1453,16,44,121,202,210,145,738
77048,Bourron-Marlotte,2683,8,134,217,305,269,194,1127
77049,Boutigny,878,4,52,68,116,144,84,468
77050,Bransles,519,8,16,29,29,70,74,226
77051,Bray-sur-Seine,2427,0,47,41,180,308,358,934
77052,Breau,346,0,8,54,50,58,31,201
77053,Brie-Comte-Robert,16075,13,397,1285,2452,2475,1644,8266
77054,La Brosse-Montceaux,727,4,0,16,128,99,111,358
77055,Brou-sur-Chantereine,4324,0,83,206,635,760,453,2137
77056,Burcy,152,4,4,0,19,26,11,64
77057,Bussieres,461,0,16,4,48,80,72,220
77058,Bussy-Saint-Georges,25135,12,604,4001,4292,3858,1340,14107
77059,Bussy-Saint-Martin,726,0,16,92,164,88,48,408
77060,Buthiers,756,8,40,32,92,100,136,408
77061,Cannes-Ecluse,2540,4,56,100,392,324,300,1176
77062,Carnetin,488,0,30,93,59,51,21,254
77063,La Celle-sur-Morin,1269,0,36,112,252,188,136,724
77065,Cely,1226,0,45,191,145,116,87,584
77066,Cerneux,311,8,12,8,44,28,28,128
77067,Cesson,9092,9,136,1005,1642,1000,472,4264
77068,Cessoy-en-Montois,214,0,8,8,20,28,12,76
77069,Chailly-en-Biere,1974,28,63,195,297,207,233,1023
77070,Chailly-en-Brie,1443,0,60,68,211,171,203,713
77071,Chaintreaux,917,12,20,41,155,130,122,480
77072,Chalautre-la-Grande,698,16,31,35,59,98,78,317
77073,Chalautre-la-Petite,579,4,16,51,82,70,51,274
77075,Chalifert,1234,0,36,136,216,164,128,680
77076,Chalmaison,745,0,12,32,69,126,101,340
77077,Chambry,920,4,12,51,132,167,109,475
77078,Chamigny,1300,0,16,97,189,201,99,602
77079,Champagne-sur-Seine,6499,0,117,276,742,1184,908,3227
77080,Champcenest,147,22,0,9,0,22,9,62
77081,Champdeuil,662,0,15,48,123,141,56,383
77082,Champeaux,810,0,13,59,97,101,72,342
77083,Champs-sur-Marne,24499,3,505,2573,3627,4107,1968,12783
77084,Changis-sur-Marne,1084,0,39,114,161,176,74,564
77085,Chanteloup-en-Brie,2403,0,45,282,437,359,141,1264
77086,La Chapelle-Gauthier,1491,0,37,66,266,228,195,792
77087,La Chapelle-Iger,157,4,8,12,28,16,12,80
77088,La Chapelle-la-Reine,2567,12,61,150,304,486,288,1301
77089,La Chapelle-Rablais,962,0,20,78,156,148,98,500
77090,La Chapelle-Saint-Sulpice,220,0,4,15,27,62,27,135
77091,Les Chapelles-Bourbon,413,4,12,53,74,45,41,229
77093,La Chapelle-Moutils,412,4,20,12,68,56,52,212
77094,Charmentray,266,0,12,16,32,47,47,154
77095,Charny,1225,4,12,71,259,216,133,695
77096,Chartrettes,2573,8,115,360,419,209,126,1237
77097,Chartronges,285,8,4,8,27,62,27,136
77098,Chateaubleau,338,0,12,28,36,44,40,160
77099,Chateau-Landon,3125,12,68,128,280,452,332,1272
77100,Le Chatelet-en-Brie,4413,8,83,275,776,632,456,2230
77101,Chatenay-sur-Seine,955,8,20,40,136,140,140,484
77102,Chatenoy,155,0,4,7,26,22,22,81
77103,Chatillon-la-Borde,217,0,8,36,20,28,16,108
77104,Chatres,593,4,34,57,133,80,42,350
77106,Chauffry,1021,0,58,54,140,152,119,523
77107,Chaumes-en-Brie,3045,4,145,206,462,395,399,1611
77108,Chelles,52817,14,1149,4439,7550,8207,4524,25883
77109,Chenoise,1289,8,36,44,111,239,191,629
77110,Chenou,313,21,8,12,17,66,46,170
77111,Chessy,4355,0,79,632,715,769,318,2513
77112,Chevrainvilliers,223,8,8,16,32,16,16,96
77113,Chevru,1081,12,40,44,88,180,128,492
77114,Chevry-Cossigny,3897,4,89,419,607,533,310,1962
77115,Chevry-en-Sereine,507,8,40,28,68,72,40,256
77116,Choisy-en-Brie,1356,16,51,83,158,146,134,588
77117,Citry,808,12,32,40,72,112,108,376
77118,Claye-Souilly,11122,6,314,1017,1970,1680,902,5889
77119,Clos-Fontaine,265,0,4,8,37,46,67,162
77120,Cocherel,614,0,4,33,84,113,92,326
77121,Collegien,3099,0,91,340,584,486,284,1785
77122,Combs-la-Ville,21908,6,316,1895,3431,3471,2087,11206
77123,Compans,723,4,17,46,104,96,104,371
77124,Conches-sur-Gondoire,1735,0,44,283,251,132,84,794
77125,Conde-Sainte-Libiaire,1416,0,72,179,223,183,64,721
77126,Congis-sur-Therouanne,1765,8,40,84,316,232,188,868
77127,Coubert,1962,0,41,114,322,302,194,973
77128,Couilly-Pont-aux-Dames,2155,0,82,201,254,299,160,996
77129,Coulombs-en-Valois,625,28,8,36,64,76,88,300
77130,Coulommes,409,8,12,24,65,57,45,211
77131,Coulommiers,14622,9,255,542,1603,2513,1899,6821
77132,Coupvray,2656,4,83,273,454,417,167,1398
77133,Courcelles-en-Bassee,234,8,0,20,47,27,12,114
77134,Courchamp,153,0,4,12,12,20,8,56
77135,Courpalay,1413,4,52,111,151,190,214,722
77136,Courquetaine,201,8,4,36,32,20,8,108
77137,Courtacon,215,3,11,7,31,31,28,111
77138,Courtomer,535,0,16,78,86,78,53,311
77139,Courtry,6280,0,212,553,1047,843,534,3189
77140,Coutencon,289,0,8,8,32,53,61,162
77141,Coutevroult,996,8,29,102,176,151,98,564
77142,Crecy-la-Chapelle,4250,12,140,464,644,640,404,2304
77143,Cregy-les-Meaux,4339,0,56,268,720,848,476,2368
77144,Crevecoeur-en-Brie,303,0,16,8,32,36,57,149
77145,Crisenoy,624,0,16,44,83,99,75,317
77146,Croissy-Beaubourg,1988,0,63,283,299,241,66,952
77147,La Croix-en-Brie,669,12,24,24,76,103,91,330
77148,Crouy-sur-Ourcq,1745,0,28,92,255,263,263,901
77149,Cucharmoy,237,0,8,13,42,29,42,134
77150,Cuisy,439,0,8,36,60,76,48,228
77151,Dagny,337,0,0,16,32,61,44,153
77152,Dammarie-les-Lys,20661,3,446,1073,2382,3170,2661,9735
77153,Dammartin-en-Goele,8258,0,183,647,1484,1305,784,4403
77154,Dammartin-sur-Tigeaux,913,0,33,119,148,160,45,505
77155,Dampmart,3179,4,76,276,428,424,324,1532
77156,Darvault,818,0,23,59,121,117,63,383
77157,Dhuisy,281,12,4,24,37,24,8,109
77158,Diant,196,13,4,13,38,29,21,118
77159,Donnemarie-Dontilly,2838,12,58,105,246,421,339,1181
77161,Dormelles,862,13,46,118,126,67,34,404
77162,Doue,1009,24,24,64,164,152,88,516
77163,Douy-la-Ramee,301,0,4,31,35,46,31,147
77164,Echouboulains,505,8,8,23,86,55,67,247
77165,Les Ecrennes,608,0,32,36,92,145,72,377
77166,Ecuelles,2443,8,48,152,368,360,240,1176
77167,Egligny,311,8,8,4,28,60,40,148
77168,Egreville,2182,12,89,93,199,333,284,1010
77169,Emerainville,7253,0,134,753,1384,1209,709,4189
77170,Episy,527,0,15,80,103,69,34,301
77171,Esbly,5882,0,125,650,1026,979,403,3183
77172,Esmans,889,12,12,44,89,173,113,443
77173,Etrepilly,848,4,24,40,132,148,128,476
77174,Everly,592,0,16,16,60,108,84,284
77175,Evry-Gregy-sur-Yerre,2485,15,151,317,325,313,135,1256
77176,Faremoutiers,2465,8,59,162,379,419,277,1304
77177,Favieres,1101,4,52,116,176,112,112,572
77178,Fay-les-Nemours,486,8,29,46,50,50,46,229
77179,Fericy,582,4,20,106,79,59,27,295
77180,Ferolles-Attilly,1135,4,35,141,165,173,82,600
77181,Ferrieres-en-Brie,2243,8,82,259,416,267,176,1208
77182,La Ferte-Gaucher,4557,8,112,64,332,680,608,1804
77183,La Ferte-sous-Jouarre,9222,8,220,448,1035,1707,1016,4434
77184,Flagy,645,4,12,61,77,81,73,308
77185,Fleury-en-Biere,639,4,28,76,72,68,64,312
77186,Fontainebleau,14708,10,418,1874,1724,1642,745,6413
77187,Fontaine-Fourches,595,12,56,24,36,92,64,284
77188,Fontaine-le-Port,939,8,28,124,160,84,56,460
77190,Fontains,253,13,8,13,42,25,8,109
77191,Fontenailles,1062,0,32,96,164,140,108,540
77192,Fontenay-Tresigny,5218,20,180,322,663,820,620,2625
77193,Forfry,271,0,20,24,36,40,28,148
77194,Forges,413,8,12,16,48,70,66,220
77195,Fouju,562,0,12,31,89,113,58,303
77196,Fresnes-sur-Marne,657,4,8,72,116,92,92,384
77197,Fretoy,155,4,4,12,16,32,4,72
77198,Fromont,212,4,8,32,24,16,12,96
77199,Fublaines,1167,0,41,110,150,191,130,622
77200,Garentreville,103,16,8,4,8,19,8,63
77201,Gastins,684,4,20,43,113,149,102,431
77202,La Genevraye,622,0,28,68,88,68,76,328
77203,Germigny-l'Eveque,1357,0,60,128,172,176,116,652
77204,Germigny-sous-Coulombs,203,12,0,8,43,8,27,98
77205,Gesvres-le-Chapitre,165,0,0,17,25,33,8,83
77206,Giremoutiers,146,4,8,16,12,12,4,56
77207,Gironville,170,4,17,0,8,30,4,63
77208,Gouaix,1446,16,32,24,151,251,199,673
77209,Gouvernes,1101,0,44,146,190,103,79,562
77210,La Grande-Paroisse,2610,4,49,149,382,402,261,1247
77211,Grandpuits-Bailly-Carrois,1007,4,20,44,156,156,144,524
77212,Gravon,145,0,0,8,27,8,19,62
77214,Gressy,902,0,29,131,123,139,33,455
77215,Gretz-Armainvilliers,8066,0,142,461,1068,1218,1098,3987
77216,Grez-sur-Loing,1424,0,41,73,179,236,151,680
77217,Grisy-Suisnes,2395,16,109,239,392,328,206,1290
77218,Grisy-sur-Seine,100,0,4,4,4,11,19,42
77219,Guerard,2250,12,100,237,434,233,149,1165
77220,Guercheville,284,8,20,20,60,36,20,164
77221,Guermantes,1217,0,42,226,201,150,88,707
77222,Guignes,3364,0,88,132,481,673,385,1759
77223,Gurcy-le-Chatel,581,4,16,40,80,60,36,236
77224,Hautefeuille,315,0,4,24,32,32,76,168
77225,La Haute-Maison,363,8,20,4,49,69,56,206
77226,Hericy,2538,0,68,306,362,287,168,1191
77227,Herme,624,4,16,35,47,97,85,284
77228,Hondevilliers,240,12,12,20,24,48,12,128
77229,La Houssaye-en-Brie,1618,28,64,163,243,215,159,872
77230,Ichy,173,8,11,11,34,11,23,98
77231,Isles-les-Meldeuses,776,0,20,32,83,151,111,397
77232,Isles-les-Villenoy,911,4,36,69,157,129,85,480
77233,Iverny,585,12,20,32,72,120,72,328
77234,Jablines,650,4,20,55,110,95,71,355
77235,Jaignes,291,4,4,38,42,42,25,155
77236,Jaulnes,357,0,0,24,40,36,77,177
77237,Jossigny,632,4,48,52,96,88,64,352
77238,Jouarre,4184,32,76,201,535,680,430,1954
77239,Jouy-le-Chatel,1469,19,50,103,176,241,180,769
77240,Jouy-sur-Morin,2171,12,53,53,215,320,369,1022
77241,Juilly,2189,8,28,73,248,382,301,1040
77242,Jutigny,560,4,16,21,66,78,70,255
77243,Lagny-sur-Marne,20306,7,450,1992,3094,2930,2102,10575
77244,Larchant,751,8,32,84,108,92,44,368
77245,Laval-en-Brie,462,8,12,4,49,49,86,208
77246,Lechelle,563,4,0,32,97,44,81,258
77247,Lescherolles,482,0,28,36,52,52,72,240
77248,Lesches,701,0,20,93,129,73,32,347
77249,Lesigny,7429,8,320,965,1037,949,316,3595
77250,Leudon-en-Brie,164,4,4,0,20,36,12,76
77251,Lieusaint,10441,3,209,742,1760,1987,1066,5767
77252,Limoges-Fourches,469,0,29,29,74,79,45,256
77253,Lissy,196,0,4,4,50,29,25,112
77254,Liverdy-en-Brie,1298,0,65,114,212,155,114,660
77255,Livry-sur-Seine,1927,0,40,124,304,236,128,832
77256,Lizines,174,4,0,8,16,31,27,86
77257,Lizy-sur-Ourcq,3621,8,56,112,317,614,569,1676
77258,Lognes,14410,0,328,1191,1997,3043,1626,8185
77259,Longperrier,2464,4,52,183,426,490,251,1406
77260,Longueville,1760,4,8,65,196,257,212,742
77261,Lorrez-le-Bocage-Preaux,1252,23,23,59,113,195,129,542
77262,Louan-Villegruis-Fontaine,520,12,28,28,53,61,49,231
77263,Luisetaines,238,8,8,33,29,4,25,107
77264,Lumigny-Nesles-Ormeaux,1519,24,60,116,252,232,124,808
77265,Luzancy,1073,0,28,60,112,252,104,556
77266,Machault,739,0,21,58,146,125,92,442
77267,La Madeleine-sur-Loing,332,0,19,12,39,35,43,148
77268,Magny-le-Hongre,6580,0,172,996,1024,1332,364,3888
77269,Maincy,1691,0,40,195,274,179,151,839
77270,Maisoncelles-en-Brie,855,16,56,87,115,68,36,378
77271,Maisoncelles-en-Gatinais,134,8,4,4,13,13,17,59
77272,Maison-Rouge,893,12,29,45,128,107,140,461
77273,Marchemoret,548,8,0,32,120,80,56,296
77274,Marcilly,446,0,4,38,59,50,67,218
77275,Les Marets,154,8,4,8,4,16,8,48
77276,Mareuil-les-Meaux,2241,0,57,237,331,274,221,1120
77277,Marles-en-Brie,1443,8,48,84,292,148,128,708
77278,Marolles-en-Brie,395,0,16,24,71,63,32,206
77279,Marolles-sur-Seine,1609,0,52,72,207,255,147,733
77280,Mary-sur-Marne,1207,8,44,40,183,175,131,581
77281,Mauperthuis,493,0,16,59,107,47,75,304
77282,Mauregard,317,0,4,0,73,65,57,199
77283,May-en-Multien,899,0,8,40,116,152,144,460
77284,Meaux,52225,16,845,2548,5941,9329,6427,25106
77285,Le Mee-sur-Seine,20693,0,306,788,2388,3642,2712,9836
77286,Meigneux,236,4,23,19,31,35,8,120
77287,Meilleray,511,8,12,12,44,72,76,224
77288,Melun,39497,8,556,2950,4841,7060,4702,20117
77289,Melz-sur-Seine,371,29,33,0,33,53,45,193
77290,Mery-sur-Marne,627,0,16,66,97,105,62,346
77291,Le Mesnil-Amelot,851,0,12,36,124,152,120,444
77292,Messy,1097,4,20,102,181,185,87,579
77293,Misy-sur-Yonne,983,0,25,36,153,113,73,400
77294,Mitry-Mory,18828,7,419,1032,2662,3035,2247,9402
77295,Moisenay,1238,0,56,84,184,168,120,612
77296,Moissy-Cramayel,17243,0,249,1069,2497,3282,1929,9026
77297,Mondreville,363,20,16,16,44,76,76,248
77298,Mons-en-Montois,482,0,8,49,37,53,73,220
77299,Montarlot,225,0,4,12,46,19,31,112
77300,Montceaux-les-Meaux,607,4,28,60,76,76,56,300
77301,Montceaux-les-Provins,333,4,19,12,23,70,39,167
77302,Montcourt-Fromonville,2073,4,28,153,306,343,161,995
77303,Montdauphin,234,4,8,8,16,24,41,101
77304,Montenils,34,0,0,0,0,9,9,18
77305,Montereau-Fault-Yonne,16573,5,226,428,1320,2317,2305,6601
77306,Montereau-sur-le-Jard,556,8,12,51,130,63,55,319
77307,Montevrain,8950,8,206,1226,1708,1820,567,5535
77308,Montge-en-Goele,693,4,16,68,101,97,60,346
77309,Monthyon,1644,0,48,112,276,296,156,888
77310,Montigny-le-Guesdier,298,0,12,12,28,55,48,155
77311,Montigny-Lencoup,1283,0,12,60,180,176,120,548
77312,Montigny-sur-Loing,2791,0,89,358,345,359,224,1375
77313,Montmachoux,233,4,8,24,28,36,20,120
77314,Montolivet,243,12,4,12,20,40,52,140
77315,Montry,3343,0,98,379,530,404,238,1649
77316,Moret-sur-Loing,4318,0,72,434,611,607,259,1983
77317,Mormant,4433,4,40,162,583,752,626,2167
77318,Mortcerf,1455,0,52,131,206,266,91,746
77319,Mortery,171,4,4,4,9,26,30,77
77320,Mouroux,4997,12,137,294,736,752,466,2397
77321,Mousseaux-les-Bray,707,15,11,19,92,96,88,321
77322,Moussy-le-Neuf,2935,16,72,258,549,403,295,1593
77323,Moussy-le-Vieux,987,0,16,36,236,172,116,576
77325,Mouy-sur-Seine,360,4,8,0,36,67,48,163
77326,Nandy,5851,0,107,473,894,1022,568,3064
77327,Nangis,8165,12,121,328,829,1348,1064,3702
77328,Nanteau-sur-Essonne,434,0,19,31,77,46,31,204
77329,Nanteau-sur-Lunain,679,12,16,40,81,57,32,238
77330,Nanteuil-les-Meaux,5454,4,151,418,840,873,522,2808
77331,Nanteuil-sur-Marne,478,0,4,20,48,89,61,222
77332,Nantouillet,267,0,8,8,68,24,36,144
77333,Nemours,12822,11,250,508,1111,1929,1712,5521
77335,Chauconin-Neufmontiers,2754,4,66,123,356,307,143,999
77336,Neufmoutiers-en-Brie,972,4,34,92,177,189,92,588
77337,Noisiel,15786,0,247,1345,2019,2563,1512,7686
77338,Noisy-Rudignon,599,0,20,33,74,94,74,295
77339,Noisy-sur-Ecole,2020,0,129,295,291,170,61,946
77340,Nonville,613,4,32,32,109,93,73,343
77341,Noyen-sur-Seine,370,0,21,17,54,58,50,200
77342,Obsonville,100,8,4,0,25,21,12,70
77343,Ocquerre,426,13,0,21,59,63,49,205
77344,Oissery,2124,0,28,128,355,387,279,1177
77345,Orly-sur-Morin,672,4,28,40,84,88,80,324
77347,Les Ormes-sur-Voulzie,837,0,20,28,133,137,52,370
77348,Ormesson,284,0,8,20,44,36,16,124
77349,Othis,6458,8,44,456,1224,920,656,3308
77350,Ozoir-la-Ferriere,20123,3,581,2144,2877,2669,1874,10148
77352,Ozouer-le-Voulgis,1815,8,68,112,308,332,156,984
77353,Paley,443,0,20,48,56,64,16,204
77354,Pamfou,936,4,28,47,173,122,103,477
77355,Paroy,180,8,16,4,16,28,24,96
77356,Passy-sur-Seine,47,4,4,0,0,7,18,33
77357,Pecy,819,8,36,40,88,120,104,396
77358,Penchard,1055,4,37,65,151,126,130,513
77359,Perthes,2127,4,140,236,292,204,144,1020
77360,Pezarches,395,16,12,23,66,55,35,207
77361,Pierre-Levee,473,4,20,32,79,91,51,277
77363,Le Pin,1269,0,39,107,223,188,103,660
77364,Le Plessis-aux-Bois,236,4,15,0,39,42,39,139
77365,Le Plessis-Feu-Aussoux,545,0,12,48,56,100,96,312
77366,Le Plessis-l'Eveque,257,0,0,37,37,41,25,140
77367,Le Plessis-Placy,272,0,12,35,28,35,39,149
77368,Poigny,496,4,12,24,56,72,87,255
77369,Poincy,701,0,27,59,106,113,55,360
77370,Poligny,823,12,36,52,92,115,92,399
77371,Pommeuse,2844,4,108,204,404,380,380,1480
77372,Pomponne,3547,0,85,291,468,568,362,1774
77373,Pontault-Combault,36458,3,880,2836,5310,6040,3846,18915
77374,Pontcarre,2014,4,44,209,322,306,173,1058
77376,Precy-sur-Marne,788,0,32,72,144,132,96,476
77377,Presles-en-Brie,2281,12,69,187,394,390,191,1243
77378,Pringy,2459,4,80,228,396,352,188,1248
77379,Provins,12206,34,228,555,1143,1859,1513,5332
77380,Puisieux,315,4,8,4,48,40,64,168
77381,Quiers,690,8,37,33,148,103,66,395
77382,Quincy-Voisins,5092,4,189,520,878,762,365,2718
77383,Rampillon,799,12,36,16,108,144,116,432
77384,Reau,1321,4,23,86,164,164,94,535
77385,Rebais,2146,0,64,36,184,380,260,924
77386,Recloses,699,0,16,88,96,96,52,348
77387,Remauville,475,13,8,4,71,55,59,210
77388,Reuil-en-Brie,837,0,28,68,131,123,95,445
77389,La Rochette,3151,0,36,372,448,412,228,1496
77390,Roissy-en-Brie,22436,0,408,1543,3219,3852,2346,11368
77391,Rouilly,486,0,8,16,52,72,68,216
77392,Rouvres,623,0,32,84,76,72,56,320
77393,Rozay-en-Brie,2770,12,35,191,374,413,284,1309
77394,Rubelles,1903,0,80,176,240,200,92,788
77395,Rumont,124,0,12,24,8,20,16,80
77396,Rupereux,102,0,4,0,8,8,24,44
77397,Saacy-sur-Marne,1760,8,52,60,169,298,214,801
77398,Sablonnieres,699,8,20,49,88,109,80,354
77399,Saint-Ange-le-Viel,229,0,12,4,32,44,20,112
77400,Saint-Augustin,1724,8,68,132,288,204,112,812
77401,Sainte-Aulde,660,15,19,34,98,106,72,344
77402,Saint-Barthelemy,397,17,13,26,39,57,61,213
77403,Saint-Brice,665,0,32,24,80,88,64,288
77404,Sainte-Colombe,1786,8,24,48,196,298,277,851
77405,Saint-Cyr-sur-Morin,1903,12,53,94,318,253,224,954
77406,Saint-Denis-les-Rebais,946,0,49,85,105,162,93,494
77407,Saint-Fargeau-Ponthierry,12909,9,333,1058,2040,1774,1190,6404
77408,Saint-Fiacre,395,0,4,27,90,39,35,195
77409,Saint-Germain-Laval,2798,8,56,120,356,436,312,1288
77410,Saint-Germain-Laxis,506,8,12,24,105,85,44,278
77411,Saint-Germain-sous-Doue,483,12,12,32,68,56,56,236
77412,Saint-Germain-sur-Ecole,353,0,24,37,85,57,8,211
77413,Saint-Germain-sur-Morin,3553,4,128,305,598,546,241,1822
77414,Saint-Hilliers,454,12,16,4,75,59,75,241
77415,Saint-Jean-les-Deux-Jumeaux,1098,8,36,75,155,186,123,583
77416,Saint-Just-en-Brie,237,4,12,8,36,44,24,128
77417,Saint-Leger,205,0,16,8,12,24,37,97
77418,Saint-Loup-de-Naud,887,0,24,28,76,156,112,396
77419,Saint-Mammes,3180,0,66,256,444,456,293,1515
77420,Saint-Mard,3816,0,109,265,539,679,402,1994
77421,Saint-Mars-Vieux-Maisons,270,16,12,8,16,32,32,116
77423,Saint-Martin-des-Champs,723,20,16,24,73,109,146,388
77424,Saint-Martin-du-Boschet,298,4,16,16,21,25,41,123
77425,Saint-Martin-en-Biere,797,8,36,103,103,95,28,373
77426,Saint-Mery,380,0,8,49,49,45,12,163
77427,Saint-Mesmes,574,8,34,27,115,99,31,314
77428,Saint-Ouen-en-Brie,860,8,28,44,184,112,76,452
77429,Saint-Ouen-sur-Morin,557,0,4,28,104,64,60,260
77430,Saint-Pathus,5901,0,120,424,1100,932,592,3168
77431,Saint-Pierre-les-Nemours,5575,12,120,320,680,768,540,2440
77432,Saint-Remy-la-Vanne,991,8,28,57,118,154,97,462
77433,Saints,1293,19,65,84,182,194,118,662
77434,Saint-Sauveur-les-Bray,339,0,4,12,43,55,31,145
77435,Saint-Sauveur-sur-Ecole,1095,4,64,141,193,85,40,527
77436,Saint-Simeon,874,4,55,35,106,110,133,443
77437,Saint-Soupplets,3231,4,59,204,425,680,367,1739
77438,Saint-Thibault-des-Vignes,6259,0,141,627,1019,982,527,3296
77439,Salins,1026,0,12,48,168,160,84,472
77440,Sammeron,1051,0,31,54,150,169,108,512
77441,Samois-sur-Seine,2100,0,40,315,323,163,40,881
77442,Samoreau,2328,0,48,269,349,293,121,1080
77443,Sancy,382,4,12,40,88,56,24,224
77444,Sancy-les-Provins,340,8,12,16,44,36,52,168
77445,Savigny-le-Temple,29074,4,414,1906,4309,5186,2919,14738
77446,Savins,621,8,21,25,41,107,74,276
77447,Seine-Port,1960,0,76,281,265,240,92,954
77448,Sept-Sorts,425,0,16,28,60,76,56,236
77449,Serris,7866,0,205,952,1369,1725,504,4755
77450,Servon,3104,0,76,380,497,419,165,1537
77451,Signy-Signets,607,4,12,32,68,72,79,267
77452,Sigy,47,12,0,8,12,4,8,44
77453,Sivry-Courtry,1027,4,25,97,156,156,97,535
77454,Sognolles-en-Montois,420,8,8,21,83,50,29,199
77455,Soignolles-en-Brie,2077,12,100,168,345,345,176,1146
77456,Soisy-Bouy,802,4,16,32,113,133,117,415
77457,Solers,1246,8,67,111,186,217,174,763
77458,Souppes-sur-Loing,5494,0,92,200,544,840,696,2372
77459,Sourdun,1457,16,37,41,152,283,152,681
77460,Tancrou,385,9,0,13,79,40,70,211
77461,Thenisy,275,8,16,12,36,52,28,152
77462,Thieux,801,4,28,20,87,126,150,415
77463,Thomery,3429,0,112,424,508,329,204,1577
77464,Thorigny-sur-Marne,9125,4,184,896,1360,1436,836,4716
77465,Thoury-Ferottes,680,0,24,24,98,118,73,337
77466,Tigeaux,375,4,20,28,63,48,32,195
77467,La Tombe,208,4,8,0,27,31,12,82
77468,Torcy,22866,4,336,1905,3464,4108,2329,12146
77469,Touquin,1093,12,64,124,132,152,92,576
77470,Tournan-en-Brie,8174,4,159,569,1190,1300,776,3998
77471,Tousson,362,24,24,12,47,51,59,217
77472,La Tretoire,441,4,8,32,72,76,52,244
77473,Treuzy-Levelay,457,0,24,28,72,89,64,277
77474,Trilbardou,652,4,15,61,177,85,54,396
77475,Trilport,4866,0,79,327,832,801,481,2520
77476,Trocy-en-Multien,265,9,4,17,34,39,51,154
77477,Ury,790,8,19,82,129,74,70,382
77478,Ussy-sur-Marne,997,16,16,64,132,128,76,432
77479,Vaires-sur-Marne,12812,0,260,1094,1865,1738,1093,6050
77480,Valence-en-Brie,904,0,28,28,182,85,80,403
77481,Vanville,167,12,4,12,32,16,36,112
77482,Varennes-sur-Seine,3377,0,56,101,354,487,427,1425
77483,Varreddes,1856,4,84,148,260,236,164,896
77484,Vaucourtois,213,0,4,12,31,39,15,101
77485,Le Vaudoue,754,4,39,102,79,110,35,369
77486,Vaudoy-en-Brie,849,8,36,64,112,96,108,424
77487,Vaux-le-Penil,10803,9,228,1113,1866,1473,854,5543
77489,Vaux-sur-Lunain,203,4,0,16,16,16,8,60
77490,Vendrest,718,4,4,36,83,126,107,360
77491,Veneux-les-Sablons,4820,4,80,623,739,526,233,2205
77492,Verdelot,709,23,39,27,82,66,102,339
77493,Verneuil-l'Etang,3185,0,44,203,406,660,374,1687
77494,Vernou-la-Celle-sur-Seine,2669,8,87,193,429,425,244,1386
77495,Vert-Saint-Denis,6986,0,124,539,1126,924,630,3343
77496,Vieux-Champagne,179,12,8,16,32,16,12,96
77498,Vignely,260,0,12,32,60,36,12,152
77500,Villebeon,457,12,4,36,52,60,40,204
77501,Villecerf,704,4,16,60,92,124,48,344
77504,Villemarechal,830,8,48,80,136,140,56,468
77505,Villemareuil,397,4,4,29,77,61,41,216
77506,Villemer,683,12,12,44,132,92,68,360
77507,Villenauxe-la-Petite,495,4,12,12,80,72,40,220
77508,Villeneuve-le-Comte,1791,0,73,198,271,210,198,950
77509,Villeneuve-les-Bordes,609,12,12,29,111,87,45,296
77510,Villeneuve-Saint-Denis,728,4,8,76,107,84,50,329
77511,Villeneuve-sous-Dammartin,636,0,12,39,95,110,102,358
77512,Villeneuve-sur-Bellot,1141,0,24,56,120,164,152,516
77513,Villenoy,4161,8,72,344,707,655,582,2368
77514,Villeparisis,24525,4,473,1619,3893,4110,2759,12858
77515,Villeroy,700,8,29,57,106,106,53,359
77516,Ville-Saint-Jacques,718,24,24,64,108,104,44,368
77517,Villevaude,2027,0,111,158,284,237,134,924
77518,Villiers-en-Biere,218,4,16,36,28,20,20,124
77519,Villiers-Saint-Georges,1205,16,32,48,103,183,127,509
77520,Villiers-sous-Grez,750,4,16,80,100,72,68,340
77521,Villiers-sur-Morin,1882,0,65,195,338,183,163,944
77522,Villiers-sur-Seine,303,0,8,12,32,44,52,148
77523,Villuis,260,0,4,8,12,23,31,78
77524,Vimpelles,503,4,20,32,44,88,88,276
77525,Vinantes,355,4,16,20,24,56,72,192
77526,Vincy-Manoeuvre,209,4,4,0,23,47,59,137
77527,Voinsles,584,20,20,28,97,85,57,307
77528,Voisenon,1027,8,36,109,150,138,81,522
77529,Voulangis,1546,4,81,97,239,210,150,781
77530,Voulton,301,8,4,16,32,56,16,132
77531,Voulx,1745,8,68,36,201,293,132,738
77532,Vulaines-les-Provins,67,0,0,0,8,19,16,43
77533,Vulaines-sur-Seine,2640,0,92,320,348,288,112,1160
77534,Yebles,664,8,28,44,85,81,77,323
78003,Ablis,3260,8,64,277,518,494,321,1682
78005,Acheres,19606,1,290,1826,3038,3394,1888,10437
78006,Adainville,753,4,39,94,114,78,39,368
78007,Aigremont,1105,0,32,268,108,40,4,452
78009,Allainville,298,8,8,24,39,36,43,158
78010,Les Alluets-le-Roi,1211,0,68,211,139,107,56,581
78013,Andelu,485,8,4,81,69,61,28,251
78015,Andresy,11980,0,228,1832,1831,1388,620,5899
78020,Arnouville-les-Mantes,864,4,32,96,160,88,68,448
78029,Aubergenville,11867,0,177,723,1773,1930,1534,6137
78030,Auffargis,1991,12,80,313,281,160,92,938
78031,Auffreville-Brasseuil,595,0,24,48,121,40,48,281
78033,Aulnay-sur-Mauldre,1156,0,40,172,176,144,128,660
78034,Auteuil,869,4,40,138,115,91,36,424
78036,Autouillet,475,0,4,73,98,29,29,233
78043,Bailly,3902,4,66,835,442,217,81,1645
78048,Bazainville,1442,12,66,207,211,161,116,773
78049,Bazemont,1517,12,36,223,195,100,76,642
78050,Bazoches-sur-Guyonne,579,0,37,106,86,37,29,295
78053,Behoust,482,4,36,53,69,32,12,206
78057,Bennecourt,1812,4,56,104,264,288,172,888
78062,Beynes,7676,4,152,951,1369,1192,416,4084
78068,Blaru,927,8,28,64,156,104,76,436
78070,Boinville-en-Mantois,321,4,24,8,52,40,32,160
78071,Boinville-le-Gaillard,616,0,16,64,125,56,60,321
78072,Boinvilliers,264,0,4,28,43,35,16,126
78073,Bois-d'Arcy,13788,3,288,1821,2157,1951,786,7006
78076,Boissets,267,8,0,29,46,38,13,134
78077,La Boissiere-Ecole,750,0,31,78,133,67,63,372
78082,Boissy-Mauvoisin,624,4,24,40,113,68,72,321
78084,Boissy-sans-Avoir,578,0,32,84,84,72,36,308
78087,Bonnelles,1922,0,44,298,368,265,103,1078
78089,Bonnieres-sur-Seine,4427,0,94,179,531,742,531,2077
78090,Bouafle,2106,4,64,268,272,288,164,1060
78092,Bougival,8472,8,179,1543,1148,953,363,4194
78096,Bourdonne,502,0,32,84,56,56,28,256
78104,Breuil-Bois-Robert,713,0,39,71,99,87,63,359
78107,Breval,1942,4,58,170,328,307,150,1017
78108,Les Breviaires,1256,20,37,180,205,164,53,659
78113,Brueil-en-Vexin,683,4,12,84,125,97,36,358
78117,Buc,5245,0,92,1112,732,420,132,2488
78118,Buchelay,2406,8,68,244,328,300,200,1148
78120,Bullion,1951,0,60,328,280,180,80,928
78123,Carrieres-sous-Poissy,15453,0,295,1635,2272,2590,1605,8397
78124,Carrieres-sur-Seine,15441,16,351,3055,2195,1709,1013,8339
78125,La Celle-les-Bordes,909,4,8,190,114,93,30,439
78126,La Celle-Saint-Cloud,21181,21,471,3416,2507,2399,998,9812
78128,Cernay-la-Ville,1642,0,68,356,220,116,36,796
78133,Chambourcy,5845,4,160,1072,764,552,200,2752
78138,Chanteloup-les-Vignes,9614,0,180,531,1090,1523,1082,4406
78140,Chapet,1195,0,31,269,156,66,47,569
78143,Chateaufort,1415,4,57,391,261,77,41,831
78146,Chatou,30281,20,730,6110,4064,2982,1131,15037
78147,Chaufour-les-Bonnieres,433,0,20,16,74,66,39,215
78152,Chavenay,1892,8,65,382,215,73,45,788
78158,Le Chesnay,29226,8,627,5842,3741,2964,843,14025
78160,Chevreuse,5808,4,165,1002,759,609,279,2818
78162,Choisel,535,0,20,102,45,49,33,249
78163,Civry-la-Foret,370,4,16,32,68,36,16,172
78164,Clairefontaine-en-Yvelines,808,0,36,144,120,80,32,412
78165,Les Clayes-sous-Bois,17678,14,277,1832,2568,2852,1297,8840
78168,Coignieres,4476,0,48,357,695,814,413,2327
78171,Conde-sur-Vesgre,1149,0,52,161,169,125,56,563
78172,Conflans-Sainte-Honorine,35582,4,646,4180,4998,4843,2864,17535
78185,Courgent,387,0,16,43,70,55,12,196
78188,Cravent,423,8,25,55,55,34,34,211
78189,Crespieres,1568,16,80,259,227,92,60,734
78190,Croissy-sur-Seine,10060,8,285,2272,977,744,269,4555
78192,Dammartin-en-Serve,1055,4,30,99,168,152,91,544
78193,Dampierre-en-Yvelines,1110,4,47,209,118,122,39,539
78194,Dannemarie,243,0,0,48,40,28,12,128
78196,Davron,328,4,19,23,50,35,23,154
78202,Drocourt,522,0,17,45,112,62,74,310
78206,Ecquevilly,3937,0,104,472,589,412,298,1875
78208,Elancourt,26389,0,383,3473,4191,4040,1798,13885
78209,Emance,859,0,8,133,160,90,31,422
78217,Epone,6473,12,140,593,874,846,591,3056
78220,Les Essarts-le-Roi,6298,8,159,816,924,837,358,3102
78224,L'Etang-la-Ville,4729,0,129,1106,529,238,81,2083
78227,Evecquemont,788,8,24,172,144,32,24,404
78230,La Falaise,607,0,21,54,141,71,54,341
78231,Favrieux,149,0,8,8,25,16,12,69
78233,Feucherolles,2847,16,88,624,264,144,72,1208
78234,Flacourt,137,4,16,16,16,16,4,72
78236,Flexanville,581,0,24,80,72,80,28,284
78237,Flins-Neuve-Eglise,163,0,4,4,40,20,16,84
78238,Flins-sur-Seine,2389,12,49,301,390,353,244,1349
78239,Follainville-Dennemont,1851,0,76,100,256,232,207,871
78242,Fontenay-le-Fleury,12981,0,210,1979,1898,1899,703,6689
78245,Fontenay-Mauvoisin,412,4,8,44,56,36,32,180
78246,Fontenay-Saint-Pere,988,0,40,139,158,107,87,531
78251,Fourqueux,4095,12,120,874,426,197,69,1698
78255,Freneuse,3933,12,64,184,461,622,493,1836
78261,Gaillon-sur-Montcient,668,0,20,71,118,75,63,347
78262,Galluis,1140,4,16,180,176,116,44,536
78263,Gambais,2445,8,106,415,322,346,118,1315
78264,Gambaiseuil,72,0,12,20,8,4,0,44
78265,Garancieres,2395,4,92,368,368,280,116,1228
78267,Gargenville,6811,0,160,512,976,904,716,3268
78269,Gazeran,1256,4,20,158,183,122,69,556
78276,Gommecourt,666,4,20,40,120,92,72,348
78278,Goupillieres,480,4,0,124,48,48,24,248
78281,Goussonville,615,0,32,76,92,96,48,344
78283,Grandchamp,313,8,32,24,32,20,12,128
78285,Gressey,542,4,20,72,88,48,44,276
78289,Grosrouvre,949,12,41,175,110,65,37,440
78290,Guernes,1010,0,60,92,200,132,64,548
78291,Guerville,2109,0,79,138,387,300,181,1085
78296,Guitrancourt,651,0,28,52,97,93,89,359
78297,Guyancourt,28245,0,360,4524,4878,4327,1721,15810
78299,Hardricourt,2076,0,56,215,330,258,195,1054
78300,Hargeville,409,0,12,56,64,48,56,236
78302,La Hauteville,175,0,4,31,20,12,12,79
78305,Herbeville,265,0,24,36,40,32,16,148
78307,Hermeray,956,20,53,134,110,94,41,452
78310,Houdan,3337,0,104,322,392,497,372,1687
78311,Houilles,31952,19,615,5157,4826,4165,1994,16776
78314,Issou,4552,0,98,248,659,814,492,2311
78317,Jambville,826,4,21,103,145,83,41,397
78320,Jeufosse,428,4,8,24,60,60,64,220
78321,Jouars-Pontchartrain,5297,4,174,954,747,469,206,2554
78322,Jouy-en-Josas,8211,8,191,1539,777,512,230,3257
78324,Jouy-Mauvoisin,553,12,16,40,80,72,40,260
78325,Jumeauville,584,4,35,82,98,63,31,313
78327,Juziers,3781,4,104,365,612,537,324,1946
78329,Lainville-en-Vexin,828,0,24,128,144,92,72,460
78334,Levis-Saint-Nom,1708,0,32,348,208,100,104,792
78335,Limay,16304,9,247,725,1946,2571,2368,7866
78337,Limetz-Villez,1904,0,52,115,266,322,206,961
78343,Les Loges-en-Josas,1546,0,36,320,184,96,40,676
78344,Lommoye,647,8,24,68,96,104,40,340
78346,Longnes,1455,8,60,131,254,202,175,830
78349,Longvilliers,510,0,29,106,69,37,25,266
78350,Louveciennes,7186,16,200,1315,678,649,233,3091
78354,Magnanville,5904,0,59,359,817,892,571,2698
78356,Magny-les-Hameaux,9100,4,148,1276,1432,1280,616,4756
78358,Maisons-Laffitte,23125,18,495,5366,2604,1810,583,10876
78361,Mantes-la-Jolie,42727,0,562,2132,4404,6017,5122,18237
78362,Mantes-la-Ville,19839,3,296,1050,2749,3028,2460,9586
78364,Marcq,711,0,19,108,124,97,31,379
78366,Mareil-le-Guyon,385,8,17,63,58,46,0,192
78367,Mareil-Marly,3518,0,140,832,332,124,40,1468
78368,Mareil-sur-Mauldre,1734,4,52,339,195,131,32,753
78372,Marly-le-Roi,16645,18,363,2995,2389,1699,453,7917
78380,Maule,5764,24,176,752,728,544,372,2596
78381,Maulette,796,0,42,63,110,110,93,418
78382,Maurecourt,4328,0,84,534,718,565,271,2172
78383,Maurepas,18928,0,284,2271,3006,2656,1190,9407
78384,Medan,1436,0,89,235,191,138,69,722
78385,Menerville,205,12,0,12,28,28,28,108
78389,Mere,1708,0,65,255,218,174,61,773
78391,Mericourt,386,4,8,36,51,83,51,233
78396,Le Mesnil-le-Roi,6408,8,180,1128,812,564,228,2920
78397,Le Mesnil-Saint-Denis,6611,4,140,1204,963,457,165,2933
78398,Les Mesnuls,863,4,33,140,127,49,21,374
78401,Meulan-en-Yvelines,8921,0,238,563,1379,1420,922,4522
78402,Mezieres-sur-Seine,3556,4,115,448,591,468,297,1923
78403,Mezy-sur-Seine,1964,8,66,231,254,254,106,919
78404,Millemont,248,0,0,29,33,29,0,91
78406,Milon-la-Chapelle,295,4,17,60,30,17,21,149
78407,Mittainville,603,4,37,98,57,37,12,245
78410,Moisson,927,0,36,104,148,80,52,420
78413,Mondreville,386,8,15,34,42,84,46,229
78415,Montainville,549,4,41,98,49,74,12,278
78416,Montalet-le-Bois,334,4,16,24,47,55,35,181
78417,Montchauvet,281,4,12,37,41,29,8,131
78418,Montesson,15270,12,373,2898,2160,1501,733,7677
78420,Montfort-l'Amaury,3127,0,117,462,390,277,121,1367
78423,Montigny-le-Bretonneux,33567,8,402,7429,5815,4304,1381,19339
78431,Morainvilliers,2473,15,93,454,339,238,86,1225
78437,Mousseaux-sur-Seine,617,0,24,60,112,68,48,312
78439,Mulcent,108,4,13,4,13,22,4,60
78440,Les Mureaux,30739,0,383,1152,3094,4835,4296,13760
78442,Neauphle-le-Chateau,3028,0,68,597,462,314,139,1580
78443,Neauphle-le-Vieux,811,0,25,161,116,81,28,411
78444,Neauphlette,881,12,12,60,140,144,80,448
78451,Nezel,1070,8,20,97,164,164,94,547
78455,Noisy-le-Roi,7765,8,246,1454,848,641,176,3373
78460,Oinville-sur-Montcient,1111,0,24,136,197,120,112,589
78464,Orcemont,843,8,12,148,124,72,24,388
78465,Orgerus,2354,0,113,255,304,312,150,1134
78466,Orgeval,5919,8,226,1205,546,412,133,2530
78470,Orphin,911,8,40,124,152,120,48,492
78472,Orsonville,331,24,8,20,28,32,40,152
78474,Orvilliers,702,4,30,53,102,83,72,344
78475,Osmoy,378,8,8,43,47,35,23,164
78478,Paray-Douaville,242,8,4,4,40,36,36,128
78481,Le Pecq,16675,9,387,2851,2071,2072,665,8055
78484,Perdreauville,630,8,13,80,84,67,29,281
78486,Le Perray-en-Yvelines,6669,0,144,792,1136,780,468,3320
78490,Plaisir,31074,3,522,3514,4810,4916,2295,16060
78497,Poigny-la-Foret,1017,4,38,226,109,92,25,494
78498,Poissy,37662,15,591,4775,5123,5303,3032,18839
78499,Ponthevrard,602,4,16,76,88,72,48,304
78501,Porcheville,3071,8,61,148,406,458,322,1403
78502,Le Port-Marly,4946,0,109,802,923,662,307,2803
78503,Port-Villez,244,0,4,12,48,24,32,120
78505,Prunay-le-Temple,404,8,20,62,59,35,12,196
78506,Prunay-en-Yvelines,816,0,24,120,116,84,76,420
78513,La Queue-les-Yvelines,2164,4,44,223,331,239,120,961
78516,Raizeux,864,0,19,119,146,65,46,395
78517,Rambouillet,25860,8,428,3196,3502,3570,1835,12539
78518,Rennemoulin,112,0,12,36,12,8,4,72
78520,Richebourg,1527,4,52,200,280,132,52,720
78522,Rochefort-en-Yvelines,937,0,63,164,126,67,55,475
78524,Rocquencourt,3217,0,104,529,405,270,89,1397
78528,Rolleboise,406,0,4,29,65,69,29,196
78530,Rosay,382,4,24,44,56,28,40,196
78531,Rosny-sur-Seine,5614,0,78,358,815,717,680,2648
78536,Sailly,380,0,20,36,65,32,32,185
78537,Saint-Arnoult-en-Yvelines,6154,4,217,695,895,748,420,2979
78545,Saint-Cyr-l'Ecole,17655,0,243,2725,2462,2508,1041,8979
78548,Saint-Forget,463,0,20,98,63,23,23,227
78550,Saint-Germain-de-la-Grange,1819,0,32,376,293,135,48,884
78551,Saint-Germain-en-Laye,40653,12,862,7550,5055,4501,1579,19559
78557,Saint-Hilarion,897,4,36,100,113,96,76,425
78558,Saint-Illiers-la-Ville,342,0,8,48,52,40,32,180
78559,Saint-Illiers-le-Bois,462,0,16,45,57,73,45,236
78561,Saint-Lambert,436,8,34,113,59,17,17,248
78562,Saint-Leger-en-Yvelines,1491,12,68,213,197,129,96,715
78564,Saint-Martin-de-Brethencourt,634,8,12,92,92,84,52,340
78565,Saint-Martin-des-Champs,317,12,8,24,36,32,8,120
78567,Saint-Martin-la-Garenne,931,0,37,115,172,103,74,501
78569,Sainte-Mesme,929,0,20,106,114,99,83,422
78571,Saint-Nom-la-Breteche,5164,32,181,1153,442,248,85,2141
78575,Saint-Remy-les-Chevreuse,7826,8,142,1699,896,580,217,3542
78576,Saint-Remy-l'Honore,1379,4,56,252,160,104,28,604
78586,Sartrouville,51431,4,1090,5351,6643,8143,4747,25978
78588,Saulx-Marchais,902,4,28,130,173,118,79,532
78590,Senlisse,538,0,20,127,44,20,12,223
78591,Septeuil,2225,4,56,268,296,204,136,964
78597,Soindres,608,0,37,53,90,98,65,343
78601,Sonchamp,1589,8,64,254,234,157,105,822
78605,Tacoignieres,1058,0,16,148,140,140,56,500
78606,Le Tartre-Gaudran,31,0,4,4,4,0,0,12
78608,Le Tertre-Saint-Denis,114,4,0,20,12,20,8,64
78609,Tessancourt-sur-Aubette,947,0,48,128,160,100,76,512
78615,Thiverval-Grignon,1030,0,41,126,119,100,44,430
78616,Thoiry,1156,4,20,154,211,110,73,572
78618,Tilly,541,4,16,64,72,84,32,272
78620,Toussus-le-Noble,1006,4,21,236,142,109,50,562
78621,Trappes,29563,6,356,1081,2997,5179,4360,13979
78623,Le Tremblay-sur-Mauldre,979,8,37,139,147,86,133,550
78624,Triel-sur-Seine,11549,8,264,1740,1730,1336,693,5771
78638,Vaux-sur-Seine,4798,0,184,741,735,503,300,2463
78640,Velizy-Villacoublay,20711,3,334,3056,3168,3319,963,10843
78642,Verneuil-sur-Seine,15466,3,333,2304,2428,1898,871,7837
78643,Vernouillet,9401,8,164,1440,1096,1016,644,4368
78644,La Verriere,5924,0,84,375,639,986,791,2875
78646,Versailles,86307,46,1535,16606,9343,9729,2480,39739
78647,Vert,797,8,24,103,134,75,44,388
78650,Le Vesinet,15929,3,442,3531,1492,1054,332,6854
78653,Vicq,338,0,32,69,24,20,20,165
78655,Vieille-Eglise-en-Yvelines,803,0,8,149,161,87,28,433
78668,La Villeneuve-en-Chevrie,572,8,8,76,84,72,56,304
78672,Villennes-sur-Seine,5103,4,183,1185,521,322,151,2366
78674,Villepreux,9888,0,156,1473,1407,1372,494,4902
78677,Villette,515,0,16,96,80,40,12,244
78681,Villiers-le-Mahieu,700,0,8,60,121,64,36,289
78683,Villiers-Saint-Frederic,2728,0,96,483,376,336,132,1423
78686,Viroflay,15723,1,230,3905,1919,1038,422,7515
78688,Voisins-le-Bretonneux,11631,3,148,2898,1688,879,293,5909
91001,Abbeville-la-Riviere,279,20,4,20,28,28,16,116
91016,Angerville,3934,20,108,132,468,668,552,1948
91017,Angervilliers,1644,4,20,196,252,188,124,784
91021,Arpajon,10704,0,206,850,1632,1580,1213,5481
91022,Arrancourt,124,8,8,16,8,16,12,68
91027,Athis-Mons,29831,0,613,1987,3982,4948,3161,14691
91035,Authon-la-Plaine,365,4,4,28,44,64,52,196
91037,Auvernaux,343,4,8,36,51,59,32,190
91038,Auvers-Saint-Georges,1237,0,30,159,197,133,102,621
91041,Avrainville,777,4,38,101,110,63,93,409
91044,Ballainvilliers,3779,4,76,520,528,388,212,1728
91045,Ballancourt-sur-Essonne,7425,4,126,540,1056,1206,747,3679
91047,Baulne,1302,0,44,120,220,204,112,700
91064,Bievres,4462,4,148,796,652,448,172,2220
91067,Blandy,118,8,0,0,8,25,29,70
91069,Boigneville,408,4,8,20,86,53,45,216
91075,Bois-Herpin,76,8,8,0,12,4,21,53
91079,Boissy-la-Riviere,559,0,20,55,102,63,24,264
91080,Boissy-le-Cutte,1319,0,20,128,217,181,145,691
91081,Boissy-le-Sec,675,16,28,44,84,101,101,374
91085,Boissy-sous-Saint-Yon,3713,0,161,342,583,526,334,1946
91086,Bondoufle,9222,4,171,1032,1559,1375,576,4717
91093,Boullay-les-Troux,640,0,20,117,101,53,28,319
91095,Bouray-sur-Juine,1990,4,33,210,326,272,144,989
91097,Boussy-Saint-Antoine,6241,0,83,686,1085,975,360,3189
91098,Boutervilliers,379,0,19,34,72,72,30,227
91099,Boutigny-sur-Essonne,3061,4,99,316,410,365,263,1457
91100,Bouville,626,12,8,97,76,93,48,334
91103,Bretigny-sur-Orge,24264,4,401,2341,3656,3666,2260,12328
91105,Breuillet,8361,4,174,894,1147,1155,641,4015
91106,Breux-Jouy,1224,0,36,95,242,159,131,663
91109,Brieres-les-Scelles,1070,0,19,81,146,180,104,530
91111,Briis-sous-Forges,3491,18,98,452,526,367,200,1661
91112,Brouy,128,4,0,15,11,19,8,57
91114,Brunoy,25492,9,488,3048,3739,3129,1787,12200
91115,Bruyeres-le-Chatel,3389,0,72,500,570,453,222,1817
91121,Buno-Bonnevaux,479,4,16,60,80,52,52,264
91122,Bures-sur-Yvette,9676,4,192,2165,1047,608,158,4174
91129,Cerny,3310,8,122,292,485,489,272,1668
91130,Chalo-Saint-Mars,1152,0,44,135,186,99,52,516
91131,Chalou-Moulineux,417,4,4,28,76,48,68,228
91132,Chamarande,1111,4,35,134,149,169,79,570
91135,Champcueil,2804,0,96,200,405,357,184,1242
91136,Champlan,2596,8,132,206,358,362,311,1377
91137,Champmotteux,384,24,12,12,60,56,48,212
91145,Chatignonville,53,0,4,8,19,8,0,39
91148,Chauffour-les-Etrechy,138,0,0,16,24,16,8,64
91156,Cheptainville,1901,8,44,217,361,201,184,1015
91159,Chevannes,1686,8,43,226,288,234,129,928
91161,Chilly-Mazarin,18843,0,407,1711,3026,2955,1739,9838
91174,Corbeil-Essonnes,44223,8,730,2117,5297,6700,6050,20902
91175,Corbreuse,1720,4,39,137,274,231,121,806
91179,Le Coudray-Montceaux,4725,0,117,468,803,646,416,2450
91180,Courances,350,8,16,61,45,40,40,210
91182,Courcouronnes,13696,3,188,1041,1807,2237,1467,6743
91184,Courdimanche-sur-Essonne,268,0,4,24,48,28,28,132
91186,Courson-Monteloup,601,0,8,91,103,47,55,304
91191,Crosne,9190,4,164,896,1664,1292,737,4757
91195,Dannemois,846,0,40,84,124,124,80,452
91198,D'Huison-Longueville,1406,0,48,137,258,205,93,741
91200,Dourdan,10036,8,173,853,1232,1522,1110,4898
91201,Draveil,28646,4,523,2795,4086,4045,2082,13535
91204,Echarcon,807,0,32,76,164,104,40,416
91207,Egly,5314,0,64,365,767,785,602,2583
91215,Epinay-sous-Senart,12129,0,128,492,1425,2369,1412,5826
91216,Epinay-sur-Orge,10349,3,189,1288,1678,1184,604,4946
91222,Estouches,208,4,0,8,40,40,40,132
91223,Etampes,24013,34,309,1222,2768,3971,3046,11350
91225,Etiolles,3101,4,121,533,497,309,102,1566
91226,Etrechy,6318,8,116,533,1009,701,484,2851
91228,Evry,52184,7,644,3180,6609,8954,5742,25136
91232,La Ferte-Alais,3994,4,120,344,643,632,389,2132
91235,Fleury-Merogis,9110,4,39,173,535,1594,541,2886
91240,Fontaine-la-Riviere,212,0,4,18,43,40,43,148
91243,Fontenay-les-Briis,1881,0,72,252,368,204,96,992
91244,Fontenay-le-Vicomte,1282,4,20,92,240,152,104,612
91247,La Foret-le-Roi,485,0,4,44,64,76,48,236
91248,La Foret-Sainte-Croix,157,4,0,0,24,32,12,72
91249,Forges-les-Bains,3748,8,157,654,512,460,274,2065
91272,Gif-sur-Yvette,20622,9,382,4740,2265,1549,564,9509
91273,Gironville-sur-Essonne,814,16,24,86,135,98,53,412
91274,Gometz-la-Ville,1387,20,16,291,230,153,48,758
91275,Gometz-le-Chatel,2622,0,53,516,325,211,170,1275
91284,Les Granges-le-Roi,1080,0,34,63,236,105,93,531
91286,Grigny,27179,0,469,536,2179,4424,3980,11588
91292,Guibeville,711,4,24,88,140,104,48,408
91293,Guigneville-sur-Essonne,923,4,36,75,130,130,67,442
91294,Guillerval,776,4,28,72,84,104,84,376
91312,Igny,10522,0,256,1920,1374,1006,456,5012
91315,Itteville,6568,4,126,560,1188,959,615,3452
91318,Janville-sur-Juine,1902,8,77,217,310,225,89,926
91319,Janvry,585,8,32,75,83,83,20,301
91326,Juvisy-sur-Orge,14924,5,282,1996,2347,2134,1291,8055
91330,Lardy,5534,4,100,589,1005,700,417,2815
91332,Leudeville,1393,4,51,170,253,209,95,782
91333,Leuville-sur-Orge,4094,0,132,480,632,629,220,2093
91338,Limours,6478,4,181,813,999,668,485,3150
91339,Linas,6519,8,199,700,908,938,609,3362
91340,Lisses,7316,0,77,691,1336,1143,618,3865
91345,Longjumeau,21510,1,326,2114,3217,3107,2107,10872
91347,Longpont-sur-Orge,6476,0,200,820,1136,696,404,3256
91359,Maisse,2698,12,89,146,334,462,301,1344
91363,Marcoussis,7987,12,236,1116,1272,828,544,4008
91374,Marolles-en-Beauce,212,0,12,29,33,25,21,120
91376,Marolles-en-Hurepoix,4870,0,71,478,814,708,332,2403
91377,Massy,43006,5,432,6237,6157,6212,3197,22240
91378,Mauchamps,283,0,8,49,49,25,0,131
91386,Mennecy,13344,14,343,1769,1933,1610,757,6426
91390,Mereville,3191,41,98,163,481,502,290,1575
91393,Merobert,559,4,4,49,53,110,86,306
91399,Mespuits,202,4,4,16,12,44,20,100
91405,Milly-la-Foret,4765,4,167,418,681,617,302,2189
91408,Moigny-sur-Ecole,1300,12,68,196,136,144,76,632
91411,Les Molieres,1971,4,80,362,271,147,95,959
91412,Mondeville,687,16,0,36,108,96,76,332
91414,Monnerville,400,4,12,28,64,52,72,232
91421,Montgeron,22941,20,473,2665,2952,2994,1652,10756
91425,Montlhery,7019,4,258,760,995,999,578,3594
91432,Morangis,12592,0,405,1178,1918,1723,1161,6385
91433,Morigny-Champigny,4305,12,136,396,652,500,320,2016
91434,Morsang-sur-Orge,21043,13,528,1785,3308,2874,1820,10328
91435,Morsang-sur-Seine,524,0,37,90,45,49,41,262
91441,Nainville-les-Roches,463,0,21,37,71,62,21,212
91457,La Norville,4048,0,76,584,664,492,264,2080
91458,Nozay,4736,0,112,766,758,559,255,2450
91461,Ollainville,4560,8,155,460,665,737,374,2399
91463,Oncy-sur-Ecole,973,0,31,58,128,155,109,481
91468,Ormoy,1894,0,63,204,318,220,134,939
91469,Ormoy-la-Riviere,943,12,32,100,116,84,92,436
91471,Orsay,15903,0,283,3478,1749,1216,602,7328
91473,Orveau,196,12,4,28,36,20,8,108
91477,Palaiseau,30316,13,377,5380,4245,3433,1639,15087
91479,Paray-Vieille-Poste,7171,16,232,405,960,1078,625,3316
91482,Pecqueuse,626,8,20,100,92,64,32,316
91494,Le Plessis-Pate,4158,0,75,613,780,542,228,2238
91495,Plessis-Saint-Benoist,308,4,0,44,36,24,20,128
91507,Prunay-sur-Essonne,314,4,8,44,48,28,36,168
91508,Puiselet-le-Marais,276,0,15,38,23,38,19,133
91511,Pussay,1982,4,33,88,283,246,279,933
91514,Quincy-sous-Senart,8209,0,156,576,1056,1436,648,3872
91519,Richarville,406,0,12,40,56,52,48,208
91521,Ris-Orangis,26988,5,512,1687,3371,4377,2867,12819
91525,Roinville,1243,8,28,172,220,136,88,652
91526,Roinvilliers,91,0,0,12,16,20,8,56
91533,Saclas,1805,4,56,149,253,261,137,860
91534,Saclay,3439,0,49,780,420,280,136,1665
91538,Saint-Aubin,695,0,16,171,111,36,12,346
91540,Saint-Cheron,4817,8,104,494,725,629,375,2335
91544,Saint-Cyr-la-Riviere,505,4,28,48,96,60,40,276
91546,Saint-Cyr-sous-Dourdan,1007,0,16,92,152,92,68,420
91547,Saint-Escobille,452,8,16,28,90,47,55,244
91549,Sainte-Genevieve-des-Bois,34771,3,692,2977,4830,5356,3388,17246
91552,Saint-Germain-les-Arpajon,9324,0,208,684,1268,1356,1036,4552
91553,Saint-Germain-les-Corbeil,7242,0,155,995,1161,840,297,3448
91556,Saint-Hilaire,393,4,4,64,68,44,24,208
91560,Saint-Jean-de-Beauregard,279,0,12,32,48,28,16,136
91568,Saint-Maurice-Montcouronne,1626,8,61,281,346,147,73,916
91570,Saint-Michel-sur-Orge,20224,7,313,1775,3191,3359,1734,10379
91573,Saint-Pierre-du-Perray,8618,8,176,940,1448,1316,512,4400
91577,Saintry-sur-Seine,5140,8,158,549,825,625,352,2517
91578,Saint-Sulpice-de-Favieres,324,0,24,44,36,36,12,152
91579,Saint-Vrain,2850,0,65,331,499,314,205,1414
91581,Saint-Yon,899,0,49,131,160,78,74,492
91587,Saulx-les-Chartreux,5065,8,192,630,763,699,422,2714
91589,Savigny-sur-Orge,37132,6,803,3939,5535,5023,3131,18437
91593,Sermaise,1666,8,57,154,247,202,125,793
91599,Soisy-sur-Ecole,1346,4,40,100,240,188,116,688
91600,Soisy-sur-Seine,6922,0,109,1172,1103,572,344,3300
91602,Souzy-la-Briche,393,0,4,47,47,39,20,157
91613,Congerville-Thionville,227,0,20,20,27,27,20,114
91617,Tigery,2918,4,38,369,551,436,144,1542
91619,Torfou,272,4,8,56,24,16,8,116
91629,Valpuiseaux,620,0,24,48,80,64,48,264
91630,Le Val-Saint-Germain,1448,4,73,206,278,117,77,755
91631,Varennes-Jarcy,2360,0,93,356,291,235,158,1133
91634,Vaugrigneuse,1288,4,41,175,171,191,102,684
91635,Vauhallan,1969,4,97,404,247,158,49,959
91639,Vayres-sur-Essonne,893,8,24,92,136,120,68,448
91645,Verrieres-le-Buisson,15534,18,374,3158,1781,1138,366,6835
91648,Vert-le-Grand,2404,12,71,257,340,524,138,1342
91649,Vert-le-Petit,2682,4,40,320,488,416,220,1488
91654,Videlles,647,8,29,54,113,59,54,317
91657,Vigneux-sur-Seine,28289,0,508,1439,3388,4801,3087,13223
91659,Villabe,5010,0,128,427,808,791,531,2685
91661,Villebon-sur-Yvette,9742,12,162,1739,1498,1194,510,5115
91662,Villeconin,731,16,44,80,72,88,40,340
91665,La Ville-du-Bois,7118,4,184,840,1208,960,632,3828
91666,Villejust,2252,4,124,196,401,349,273,1347
91667,Villemoisson-sur-Orge,6977,0,151,1052,1207,713,394,3517
91671,Villeneuve-sur-Auvers,598,16,8,44,108,48,80,304
91679,Villiers-le-Bacle,1231,0,20,264,216,112,56,668
91685,Villiers-sur-Orge,3886,0,88,484,680,516,248,2016
91687,Viry-Chatillon,31655,4,514,2361,4693,5470,2945,15987
91689,Wissous,6093,0,161,906,1032,693,430,3222
91691,Yerres,28933,0,574,3423,4760,4025,1662,14444
91692,Les Ulis,24641,1,277,1870,3259,4462,2351,12220
92002,Antony,62012,11,963,12661,7814,6206,2434,30089
92004,Asnieres-sur-Seine,83376,46,1887,14922,11172,10949,5122,44098
92007,Bagneux,38002,3,756,3223,5076,6707,3268,19033
92009,Bois-Colombes,28927,6,732,5431,4018,3516,1494,15197
92012,Boulogne-Billancourt,116220,56,3149,27470,14955,12455,3737,61822
92014,Bourg-la-Reine,19982,0,333,4651,2383,1715,593,9675
92019,Chatenay-Malabry,32083,4,520,4448,4330,4200,1926,15428
92020,Chatillon,33405,6,716,6831,5425,4253,1503,18734
92022,Chaville,18852,1,372,3943,2591,1958,726,9591
92023,Clamart,52731,20,1191,8077,7146,6803,2955,26192
92024,Clichy,59458,8,1333,7636,8560,10377,4980,32894
92025,Colombes,85102,24,1977,10476,10802,12559,6305,42143
92026,Courbevoie,88530,35,1950,20697,12492,10148,3007,48329
92032,Fontenay-aux-Roses,23288,4,359,3964,3143,3027,1106,11603
92033,Garches,18118,16,449,3668,2111,1722,564,8530
92035,La Garenne-Colombes,28297,16,674,5873,4200,3432,1304,15499
92036,Gennevilliers,41930,7,734,2012,4570,7187,4628,19138
92040,Issy-les-Moulineaux,65326,4,1234,15592,9625,7791,2419,36665
92044,Levallois-Perret,64629,30,1786,15855,9027,6758,2105,35561
92046,Malakoff,30768,0,578,4337,4659,5014,1984,16572
92047,Marnes-la-Coquette,1659,0,73,347,93,121,52,686
92048,Meudon,45010,22,947,8323,5602,5083,2079,22056
92049,Montrouge,48710,14,988,10811,7481,6142,2009,27445
92050,Nanterre,89476,6,1536,8876,10303,15532,7377,43630
92051,Neuilly-sur-Seine,61797,122,2619,14287,4990,4818,1065,27901
92060,Le Plessis-Robinson,28113,2,463,5488,4258,3728,1434,15373
92062,Puteaux,44683,17,994,10562,6238,5200,1927,24938
92063,Rueil-Malmaison,79855,37,1716,16947,10799,8397,2896,40792
92064,Saint-Cloud,29194,34,823,7290,2886,2252,627,13912
92071,Sceaux,19930,1,394,4316,2185,1680,528,9104
92072,Sevres,23278,14,586,5135,2898,2309,860,11802
92073,Suresnes,46876,10,1098,10199,6002,5816,2117,25242
92075,Vanves,27022,24,612,5307,3977,3294,1115,14329
92076,Vaucresson,8612,8,320,1920,708,636,156,3748
92077,Ville-d'Avray,10733,1,258,2360,1066,864,251,4800
92078,Villeneuve-la-Garenne,25644,4,474,1263,2804,4572,2815,11932
93001,Aubervilliers,75598,18,1901,2728,5957,13214,10434,34252
93005,Aulnay-sous-Bois,81880,3,1671,4194,8191,12714,10243,37016
93006,Bagnolet,34513,4,894,3293,3872,5489,3480,17032
93007,Le Blanc-Mesnil,51916,0,1188,1687,5116,8794,6756,23541
93008,Bobigny,47224,5,938,1644,3639,8543,6134,20903
93010,Bondy,53051,9,1131,2307,5787,8983,6148,24365
93013,Le Bourget,14978,5,326,912,1725,2360,1727,7055
93014,Clichy-sous-Bois,29835,3,649,568,1946,4501,4168,11835
93015,Coubron,4712,0,92,495,856,682,350,2475
93027,La Courneuve,38789,8,846,907,2707,6977,5704,17149
93029,Drancy,66635,11,1495,2626,7129,11319,8297,30877
93030,Dugny,10783,0,173,447,1328,2316,1246,5510
93031,Epinay-sur-Seine,54540,13,1057,1830,5405,9488,6014,23807
93032,Gagny,39378,8,904,3045,5415,6083,3263,18718
93033,Gournay-sur-Marne,6485,0,214,962,1011,744,353,3284
93039,L'Ile-Saint-Denis,7037,0,124,420,760,1180,780,3264
93045,Les Lilas,22505,5,552,3088,3413,3059,1231,11348
93046,Livry-Gargan,42036,5,1139,2836,6184,6404,3837,20405
93047,Montfermeil,25963,7,720,1081,2632,3739,2865,11044
93048,Montreuil,103068,17,2124,11679,12922,15407,10528,52677
93049,Neuilly-Plaisance,20703,1,488,2531,3039,2901,1648,10608
93050,Neuilly-sur-Marne,34005,4,589,2416,4814,6232,3367,17422
93051,Noisy-le-Grand,62970,13,1388,6571,9162,10485,5537,33156
93053,Noisy-le-Sec,40232,3,772,2224,4490,7217,4515,19221
93055,Pantin,53797,1,1175,4384,6476,8863,5642,26541
93057,Les Pavillons-sous-Bois,22117,3,675,1691,3032,3418,2127,10946
93059,Pierrefitte-sur-Seine,28026,0,551,903,2523,4883,3606,12466
93061,Le Pre-Saint-Gervais,18075,6,441,1943,2583,3049,1595,9617
93062,Le Raincy,13928,0,479,2026,2150,1677,717,7049
93063,Romainville,25512,5,719,1689,2679,4147,2654,11893
93064,Rosny-sous-Bois,41254,7,771,3338,5949,7145,3479,20689
93066,Saint-Denis,107762,9,2115,5844,10399,18876,14181,51424
93070,Saint-Ouen,47783,5,1228,3812,6013,8333,5423,24814
93071,Sevran,50053,1,960,1839,4997,8390,6334,22521
93072,Stains,34830,15,660,778,2886,5879,4271,14489
93073,Tremblay-en-France,34452,3,708,1800,4508,5766,3631,16416
93074,Vaujours,6643,0,172,507,1132,1070,641,3522
93077,Villemomble,28368,0,815,2960,3742,4170,2324,14011
93078,Villepinte,35850,3,655,1436,4368,6009,4350,16821
93079,Villetaneuse,12642,0,267,328,1029,2561,1638,5823
94001,Ablon-sur-Seine,5221,0,114,454,830,777,433,2608
94002,Alfortville,44550,2,1075,4571,6248,7172,4204,23272
94003,Arcueil,20100,0,420,2504,2614,3193,1528,10259
94004,Boissy-Saint-Leger,16354,3,321,1039,2150,3018,1706,8237
94011,Bonneuil-sur-Marne,16237,0,265,707,1762,2892,1757,7383
94015,Bry-sur-Marne,15987,6,541,2744,2203,1796,813,8103
94016,Cachan,28404,0,410,4412,3795,3634,1534,13785
94017,Champigny-sur-Marne,75800,14,1666,5710,9184,12538,7666,36778
94018,Charenton-le-Pont,29562,7,758,5463,4572,3716,1145,15661
94019,Chennevieres-sur-Marne,17963,0,511,1566,2338,2625,1696,8736
94021,Chevilly-Larue,18532,3,370,1453,2579,3305,1670,9380
94022,Choisy-le-Roi,41355,0,811,3375,5951,6830,4271,21238
94028,Creteil,90528,8,2009,7758,11740,15607,6745,43867
94033,Fontenay-sous-Bois,52723,9,1159,7071,7246,7761,3476,26722
94034,Fresnes,26371,0,400,2702,3724,4174,1909,12909
94037,Gentilly,16892,3,363,1898,2159,2849,1438,8710
94038,L'Hay-les-Roses,30574,0,556,3896,4135,4096,1810,14493
94041,Ivry-sur-Seine,58185,16,1275,5404,7343,9815,5597,29450
94042,Joinville-le-Pont,17953,13,454,2733,2591,2421,884,9096
94043,Le Kremlin-Bicetre,26131,0,493,3661,3812,4586,1467,14019
94044,Limeil-Brevannes,20663,9,536,1491,3217,3543,1797,10593
94046,Maisons-Alfort,53265,5,1230,7316,8355,7765,3322,27993
94047,Mandres-les-Roses,4415,24,128,540,749,533,233,2207
94048,Marolles-en-Brie,4916,0,188,732,765,519,259,2463
94052,Nogent-sur-Marne,31795,18,791,6705,4501,3366,1391,16772
94053,Noiseau,4679,0,155,502,796,661,295,2409
94054,Orly,21312,0,368,963,2395,3730,2392,9848
94055,Ormesson-sur-Marne,9921,0,445,993,1222,1191,697,4548
94056,Perigny,2352,0,96,296,428,272,116,1208
94058,Le Perreux-sur-Marne,33214,24,938,5730,4926,3711,1620,16949
94059,Le Plessis-Trevise,19095,0,616,2009,2723,2853,1363,9564
94060,La Queue-en-Brie,11506,0,231,991,1705,1638,1074,5639
94065,Rungis,5681,0,160,848,1104,924,256,3292
94067,Saint-Mande,22292,6,810,4946,3032,2234,621,11649
94068,Saint-Maur-des-Fosses,74818,20,2160,12783,10290,8164,3260,36677
94069,Saint-Maurice,14586,3,391,2608,2285,2116,680,8083
94070,Santeny,3688,16,178,457,416,368,182,1617
94071,Sucy-en-Brie,25655,11,635,3288,3605,3179,1615,12333
94073,Thiais,29229,5,563,2898,4445,4493,2269,14673
94074,Valenton,11940,3,200,276,1236,2282,1574,5571
94075,Villecresnes,9712,8,302,952,1431,1406,601,4700
94076,Villejuif,55923,15,1061,5159,6976,9445,4654,27310
94077,Villeneuve-le-Roi,18610,0,461,1074,2204,2842,2274,8855
94078,Villeneuve-Saint-Georges,32767,2,675,1103,3289,6380,4776,16225
94079,Villiers-sur-Marne,27222,7,536,2621,3755,4071,2188,13178
94080,Vincennes,48649,11,1288,12549,7125,4916,1544,27433
94081,Vitry-sur-Seine,86375,0,2075,5778,10089,14339,9139,41420
95002,Ableiges,933,8,12,115,166,111,63,475
95008,Aincourt,967,4,4,64,184,172,120,548
95011,Ambleville,424,0,16,20,61,57,52,206
95012,Amenucourt,207,0,12,20,36,32,24,124
95014,Andilly,2520,0,76,360,396,248,148,1228
95018,Argenteuil,104282,62,2239,6416,12427,16895,11897,49936
95019,Arnouville,13737,5,397,748,1797,2021,1473,6441
95023,Arronville,656,4,28,63,130,83,36,344
95024,Arthies,304,4,4,37,54,42,17,158
95026,Asnieres-sur-Oise,2531,4,104,292,446,304,176,1326
95028,Attainville,1825,12,40,180,341,217,140,930
95039,Auvers-sur-Oise,6789,4,177,788,1149,842,382,3342
95040,Avernes,827,8,21,111,144,74,70,428
95042,Baillet-en-France,2001,8,57,255,361,215,113,1009
95046,Banthelu,125,0,4,16,25,8,0,53
95051,Beauchamp,8713,0,203,974,1184,1056,630,4047
95052,Beaumont-sur-Oise,9228,8,211,487,1370,1577,1083,4736
95054,Le Bellay-en-Vexin,248,0,8,29,37,24,20,118
95055,Bellefontaine,433,4,4,40,80,48,44,220
95056,Belloy-en-France,2017,12,46,151,376,282,163,1030
95058,Bernes-sur-Oise,2389,12,73,137,253,358,300,1133
95059,Berville,335,8,16,32,51,43,43,193
95060,Bessancourt,6811,0,169,735,1192,948,503,3547
95061,Bethemont-la-Foret,425,0,16,79,67,40,20,222
95063,Bezons,28330,1,634,1660,3422,5060,3318,14095
95074,Boisemont,746,0,40,120,104,96,36,396
95078,Boissy-l'Aillerie,1769,0,36,212,332,192,136,908
95088,Bonneuil-en-France,712,0,28,36,100,132,48,344
95091,Bouffemont,5942,0,105,605,967,842,383,2902
95094,Bouqueval,338,0,17,0,46,63,50,176
95101,Bray-et-Lu,971,0,24,57,146,113,89,429
95102,Breancon,362,8,23,55,43,39,20,188
95110,Brignancourt,202,0,16,16,24,16,16,88
95116,Bruyeres-sur-Oise,3761,0,41,163,558,680,520,1962
95119,Buhy,310,4,16,12,57,36,44,169
95120,Butry-sur-Oise,2057,12,64,208,404,240,148,1076
95127,Cergy,58341,12,706,5829,8521,10100,5254,30422
95134,Champagne-sur-Oise,4685,12,120,460,748,748,384,2472
95139,La Chapelle-en-Vexin,331,4,8,24,73,69,24,202
95141,Charmont,27,0,0,4,4,12,0,20
95142,Chars,1862,4,42,147,293,280,172,938
95144,Chatenay-en-France,71,0,8,34,4,8,11,65
95149,Chaumontel,3298,4,77,306,586,435,255,1663
95150,Chaussy,627,0,20,84,112,84,40,340
95151,Chauvry,304,0,4,40,36,36,8,124
95154,Chennevieres-les-Louvres,336,0,4,21,38,67,46,176
95157,Cherence,153,4,11,18,11,4,4,52
95166,Clery-en-Vexin,404,0,20,36,67,51,47,221
95169,Commeny,384,4,8,35,71,47,32,197
95170,Condecourt,557,8,27,71,102,63,27,298
95176,Cormeilles-en-Parisis,23497,6,565,3046,3847,2969,1560,11993
95177,Cormeilles-en-Vexin,1133,24,73,114,139,159,61,570
95181,Courcelles-sur-Viosne,307,0,8,60,56,40,12,176
95183,Courdimanche,6533,8,103,929,1143,1042,415,3640
95197,Deuil-la-Barre,21638,3,509,2485,3781,3098,1356,11232
95199,Domont,14996,19,349,1314,2409,2319,1192,7602
95203,Eaubonne,24300,0,569,2802,3367,3426,1586,11750
95205,Ecouen,7313,0,145,690,1262,1230,561,3888
95210,Enghien-les-Bains,11560,0,398,2060,1686,1179,435,5758
95211,Ennery,2268,0,76,271,401,269,119,1136
95212,Epiais-les-Louvres,98,0,4,11,15,15,15,60
95213,Epiais-Rhus,649,0,12,105,117,52,36,322
95214,Epinay-Champlatreux,68,0,4,0,16,4,12,36
95218,Eragny,16912,5,336,1645,2535,2648,1427,8596
95219,Ermont,27304,9,439,2971,3835,3991,2036,13281
95229,Ezanville,9262,0,140,793,1450,1647,832,4862
95241,Fontenay-en-Parisis,1894,8,4,200,304,264,208,988
95250,Fosses,9574,0,188,475,1473,1489,1042,4667
95252,Franconville,33512,4,623,2764,5114,5488,2899,16892
95253,Fremainville,492,0,20,98,49,20,33,220
95254,Fremecourt,539,0,12,52,123,95,60,342
95256,Frepillon,2820,4,77,311,496,339,182,1409
95257,La Frette-sur-Seine,4574,0,140,728,696,516,236,2316
95258,Frouville,364,0,20,66,47,51,31,215
95259,Gadancourt,93,0,4,4,9,13,0,30
95268,Garges-les-Gonesse,39730,4,625,711,2909,6792,5149,16190
95270,Genainville,564,4,36,60,92,88,36,316
95271,Genicourt,490,8,24,92,68,84,24,300
95277,Gonesse,26516,10,475,920,2820,4801,3349,12375
95280,Goussainville,31129,7,650,877,2826,5009,4733,14102
95282,Gouzangrez,176,0,4,32,40,28,16,120
95287,Grisy-les-Platres,617,0,24,92,72,80,36,304
95288,Groslay,8620,0,281,906,1322,1199,615,4323
95295,Guiry-en-Vexin,159,7,0,19,37,26,15,104
95298,Haravilliers,548,4,37,53,85,41,28,248
95301,Haute-Isle,314,0,31,20,39,20,24,134
95303,Le Heaulme,198,0,12,27,31,19,23,112
95304,Hedouville,246,0,16,43,24,20,4,107
95306,Herblay,26422,13,666,3217,4095,3568,1733,13292
95308,Herouville,607,4,16,80,100,68,36,304
95309,Hodent,241,4,0,24,48,24,8,108
95313,L'Isle-Adam,11880,6,412,1273,1632,1436,829,5588
95316,Jagny-sous-Bois,250,4,12,32,44,40,4,136
95323,Jouy-le-Moutier,16376,8,279,1615,2648,2757,1419,8726
95328,Labbeville,567,4,8,88,88,64,68,320
95331,Lassy,185,4,4,20,32,12,20,92
95341,Livilliers,386,4,4,60,68,20,36,192
95348,Longuesse,532,8,24,80,80,56,28,276
95351,Louvres,9553,16,74,485,1525,1677,993,4770
95352,Luzarches,4362,12,98,409,806,476,334,2135
95353,Maffliers,1691,0,41,210,342,231,91,915
95355,Magny-en-Vexin,5858,8,91,418,713,867,668,2765
95365,Mareil-en-France,700,0,17,79,133,91,41,361
95369,Margency,2872,0,90,452,507,250,152,1451
95370,Marines,3313,4,65,323,549,457,323,1721
95371,Marly-la-Ville,5502,12,99,490,933,842,407,2783
95379,Maudetour-en-Vexin,199,0,0,28,36,8,8,80
95387,Menouville,91,0,4,12,4,12,8,40
95388,Menucourt,5363,0,84,544,872,780,400,2680
95392,Meriel,4756,17,133,467,882,604,304,2407
95394,Mery-sur-Oise,9290,12,251,909,1575,1200,825,4772
95395,Le Mesnil-Aubry,897,8,31,62,120,124,124,469
95409,Moisselles,1256,0,49,131,290,150,80,700
95422,Montgeroult,416,0,4,67,55,51,13,190
95424,Montigny-les-Cormeilles,19442,0,506,1175,2445,3315,2159,9600
95426,Montlignon,2607,0,96,413,394,193,124,1220
95427,Montmagny,14003,3,303,874,1824,2294,1379,6677
95428,Montmorency,20945,10,585,2930,2920,2481,1059,9985
95429,Montreuil-sur-Epte,442,0,20,16,84,32,36,188
95430,Montsoult,3393,0,75,330,509,560,215,1689
95436,Mours,1340,4,24,145,226,198,89,686
95438,Moussy,145,0,0,12,23,27,19,81
95445,Nerville-la-Foret,642,0,35,89,82,47,23,276
95446,Nesles-la-Vallee,1808,4,85,209,358,209,137,1002
95447,Neuilly-en-Vexin,199,0,8,21,34,17,13,93
95450,Neuville-sur-Oise,1994,10,66,428,275,92,81,952
95452,Nointel,846,0,37,111,111,130,69,458
95456,Noisy-sur-Oise,688,0,20,60,100,112,84,376
95459,Nucourt,722,4,20,72,112,76,68,352
95462,Omerville,306,0,4,20,55,43,20,142
95476,Osny,16333,5,313,1599,2229,2201,1283,7630
95480,Parmain,5553,8,181,663,908,679,329,2768
95483,Le Perchay,556,8,24,47,122,51,35,287
95487,Persan,10790,20,145,282,1150,1825,1756,5178
95488,Pierrelaye,8012,4,166,455,1075,1329,1061,4090
95489,Piscop,725,4,39,63,122,106,63,397
95491,Le Plessis-Bouchard,7763,12,188,944,1344,1008,472,3968
95492,Le Plessis-Gassot,69,4,4,4,4,16,12,44
95493,Le Plessis-Luzarches,135,0,4,15,26,11,23,79
95500,Pontoise,29885,5,473,2734,4120,4765,2835,14932
95504,Presles,3745,0,105,478,587,482,259,1911
95509,Puiseux-en-France,3277,4,87,271,554,501,306,1723
95510,Puiseux-Pontoise,422,0,4,25,91,78,21,219
95523,La Roche-Guyon,458,0,32,40,75,52,44,243
95527,Roissy-en-France,2869,0,36,164,556,796,300,1852
95529,Ronquerolles,860,0,24,108,148,80,32,392
95535,Sagy,1155,8,48,116,204,152,68,596
95539,Saint-Brice-sous-Foret,14361,1,431,1319,2149,2174,1078,7152
95541,Saint-Clair-sur-Epte,958,0,32,28,96,112,160,428
95543,Saint-Cyr-en-Arthies,231,0,4,27,23,50,15,119
95554,Saint-Gervais,961,12,36,84,180,104,64,480
95555,Saint-Gratien,20453,0,419,2080,2868,3157,1548,10072
95563,Saint-Leu-la-Foret,14800,0,354,1885,2368,1760,842,7209
95566,Saint-Martin-du-Tertre,2649,0,70,176,439,406,238,1329
95572,Saint-Ouen-l'Aumone,23731,11,447,1676,3154,3899,2967,12154
95574,Saint-Prix,7243,0,217,1036,1056,692,400,3401
95580,Saint-Witz,2603,0,94,424,371,249,53,1191
95582,Sannois,26707,4,596,2655,3841,4128,2299,13523
95584,Santeuil,623,0,19,74,128,66,58,345
95585,Sarcelles,58398,13,1212,1652,5051,10311,6977,25216
95592,Seraincourt,1320,8,67,118,228,130,102,653
95594,Seugy,1030,0,32,135,195,131,68,561
95598,Soisy-sous-Montmorency,17531,4,456,1977,2501,2381,1059,8378
95604,Survilliers,3943,0,51,241,681,700,416,2089
95607,Taverny,26195,9,533,2568,4140,3942,1996,13188
95610,Themericourt,268,0,20,27,43,39,8,137
95611,Theuville,27,0,0,17,0,4,4,25
95612,Le Thillay,4124,4,84,196,503,691,563,2041
95625,Us,1327,12,16,125,230,169,137,689
95627,Vallangoujard,634,0,40,80,76,88,52,336
95628,Valmondois,1207,0,48,120,225,120,112,625
95633,Vaudherland,79,0,0,0,12,12,16,40
95637,Vaureal,16223,0,247,1855,2743,2720,1319,8884
95641,Vemars,2201,4,56,216,413,348,212,1249
95651,Vetheuil,901,0,33,94,159,85,53,424
95652,Viarmes,5084,4,156,472,768,644,412,2456
95656,Vienne-en-Arthies,417,0,24,45,57,45,33,204
95658,Vigny,1072,16,36,160,164,84,64,524
95660,Villaines-sous-Bois,682,0,39,78,124,78,74,393
95675,Villeron,844,0,37,74,182,148,79,520
95676,Villers-en-Arthies,470,0,8,45,97,45,37,232
95678,Villiers-Adam,828,0,20,68,124,92,44,348
95680,Villiers-le-Bel,27428,3,457,773,2578,4727,3543,12081
95682,Villiers-le-Sec,182,4,0,8,17,37,21,87
95690,Wy-dit-Joli-Village,322,8,0,44,64,28,24,168
